***disclaimer: this is unfinished in terms of detail, so although its important mechanic works, some rooms (especially later on) might not have much to examine, and the game is overall more linear than I'd like.***

Try Again
An Interactive Fiction by Tulasi H
Release 1 / Serial number 200710 / Inform 7 build 6M62 (I6/v6.34 lib 6/12N) SD

Cell
This room is depressingly familiar. You've paced across every inch of the cold gray concrete, stood on tiptoes to see out of the barred window, tossed and turned under the thin blanket on your cot. A small camera is embedded above the locked cell door on the north wall.

>look
Cell
This room is depressingly familiar. You've paced across every inch of the cool gray concrete, stood on tiptoes to see out of the barred window, tossed and turned under the thin blankets on your cot. Perched above the locked door on the cell's north wall, a small camera is embedded in the wall.

* * *

>listen
Suddenly, the stark white light in the ceiling flickers out. The cell is pitch-black at first, but you can clearly hear the grating sound that your cell door makes when it retracts upward. The cooler air from the hall outside floods in.
Just as your eyes begin to adjust, an eerie red emergency light fades up. The dim light confirms what you heard and felt: the door is open. Above it, the camera blinks back on, and glimmers tauntingly as you stare at it.
You register the blaring alarm sound that must have started sometime in the past minute, but otherwise the facility is deathly still. This is your chance to escape.

* * *

>n
The cell door is locked. It cannot be opened from the inside.

>n
The cell door is locked. It cannot be opened from the inside.

>e
You can't go that way.

>w
Cell2

>n
You can't go that way.

>e
Hall2

>n
Intersection

>e
CorridorA

>w
Intersection

>w
CorridorB

>w
CorridorC

>w
You can't go that way.

>nw
Waiting Room

>nw
Data Mining

>up
Data Mining2

* * *

>n
The cell door is locked. It cannot be opened from the inside.

>n
The cell door is locked. It cannot be opened from the inside.

Suddenly, the stark white light in the ceiling flickers out. The cell is pitch-black at first, but you can clearly hear the grating sound that your cell door makes when it retracts upward. The cooler air from the hall outside floods in.

Just as your eyes begin to adjust, an eerie red emergency light fades up. The dim light confirms what you heard and felt: the door is open. Above it, the camera blinks back on, and glimmers tauntingly as you stare at it.

You register a blaring alarm sound that must have started sometime in the past minute, but otherwise the facility is deathly still. It must be a power outage, or worse. Whatever the case, this is your chance to escape.

>n
South Hall
The hall is flooded with red light and the sound of alarms. Your cell is one of many cells that branches off of it, and every door down the length of the hall is now open. To the south, you know there are branching hallways that lead deeper into this wing of the facility, and to the north is the main corridor that runs through the complex.

>n
Intersection
Here, the narrow central hall of your cell's wing meets a wider corridor. The alarms are still blaring, and the light still dim, but you've been this way before (albeit under close supervision). The corridor runs from east to west, and though you can't see far in either direction, you don't hear or see anyone else.

>e
Corridor (east)
A wider hall with an arched ceiling. This is where you pass through regularly to get to other parts of the facility, so despite the lack of light you can navigate it easily. On the south wall, there is a small door that you have walked past often but never entered. The corridor continues to the east.

>e
Dead End
The corridor curves around toward the northeast, but it ends in a door which seems firmly shut. Up above your head is a large air vent, part of the facility's ventilation system.

* * *

>e
Corridor (east)
A wider hall with an arched ceiling. This is where you pass through regularly to get to other parts of the facility, so despite the lack of light you can navigate it easily. On the south wall, there is a small door that you have walked past often but never entered. The corridor continues to the east.

>s
Storage Room
Dark and cluttered. Most of the boxes here are sealed; you probably shouldn't waste time looking through them. A ladder stands in the corner. On top of a pile of junk, there is one open box. The storage room's door is in the north wall.

>take ladder
Taken.

>take screwdriver
Taken.

>n
Corridor (east)

>e
Dead End
The corridor curves around toward the northeast, but it ends in a door which seems firmly shut. Up above your head is a large air vent, part of the facility's ventilation system.

>up
You place the ladder in front of the door and climb up to the air vent. It has a metal grate covering it, but you unscrew the corners with your screwdriver and let it clatter to the ground. It's a tight fit, but you squeeze yourself into the vent.

Air Vent
A cramped space with cold air rushing through. The vent continues to the northeast.

>ne
Air Vent (intersection)
From here, the vent ends to the northeast and branches off to the south. The grate to the northeast has wide enough bars that you could reach through and unscrew it, and the drop to the floor doesn't look too bad.

>ne
Visitation
Although it's as cold and empty as the rest of the facility right now, and looks foreboding under the red light, this room is the only one that can be downright joyous at times. Here, you can greet friends and family, even if the pane of polished glass bisecting the room prevents real contact. The pane is dotted with two-way speakers, separated by plastic dividers for a measly amount of privacy.

A door at the southeast, with a check-in machine next to it, leads to the phone bank (which is much more familiar to you than visitation). And although it's normally locked, the door in the glass divider hangs open, giving you access to two more doors on the northeast and northwest walls.

>ne
Power SourceYard (west)
Hall3
Yay more undefined rooms. Go north from here.

>n
Power Source
The lights here are so far overhead and so sparse that the room is barely navigable. It seems very quiet and still, other than the constant alarms, and the various machines that generate power for the facility don't seem to be functioning. It confirms what you thought from the beginning: this must be a power outage. There are doors to the northeast and west.

>w
Yard (west)
Hallway
This hallway heads west, toward the center of the facility. It ends at a doorway that leads west. Through it, you can feel a cool breeze.

>w
Yard (east)
The facility yard. This is where recreation takes place, though you haven't come through the main entrance for prisoners. Usually, the amount of credits you'd need to spend on rec slots is infuriating, but tonight the breath of fresh air is free. You stand against the facility wall, staying out of the better-lit yard area.

This section is fenced off, but you could definitely climb the chain-link to the west. Beyond that, it would be a clean dash to the main entrance of the facility. Now you just have to step away from the wall.

>w
Yard (west)
Yard (west)
Heart pounding, you dash away from the relative cover of the wall. You reach the chain-link fence that partitions the yard and start climbing easily enough. You're only halfway up when a floodlight turns on, and you instinctively shield your eyes.

Rapid footsteps thud toward you from several directions. By the time you lower your hand, guards are yanking you down and you land painfully on the ground. Heavy boots fill your field of vision.

A pins-and-needles feeling envelopes you, and your vision goes dark.

>look
Power SourceYard (west)RunoffVisitationPower SourceYard (west)RunoffControl RoomChapel
Visitation
Although it's as cold and empty as the rest of the facility right now, and looks foreboding under the red light, this room is the only one that can be downright joyous at times. Here, you can greet friends and family, even if the pane of polished glass bisecting the room prevents real contact. The pane is dotted with two-way speakers, separated by plastic dividers for a measly amount of privacy.

A door at the southeast, with a check-in machine next to it, leads to the phone bank (which is much more familiar to you than visitation). And although it's normally locked, the door in the glass divider hangs open, giving you access to two more doors on the northeast and northwest walls.

* * *

>nw
Guard Room
Little more than a human-sized box with a TV in the corner that shows the security feeds from the visitation room. Of course, right now the feeds show nothing interesting.

Strangely, a ladder with metal rungs is bolted into the corner, where it descends downward.

>down
Tunnel
You never knew that tunnels existed beneath the facility. The walls are rough stone, and it is just tall enough to stand without hunching over. Over the years, names and symbols have been gouged into the walls by bored facility guards. The tunnel continues to the northwest.

>nw
Tunnel (continued)
You walk for several minutes, the tunnel occasionally turning slightly. Finally, you reach a door that is slightly open, and leads to the west.

>w
Control Tower Base
A circular room with grand door on the north wall. The door you emerged from is a smaller one on the east side, and you realize that the tunnel must have been sloping upward throughout your journey, since this appears to be ground level.

An unoccupied security checkpoint is set up in front of the main door, and a spiral staircase leads upward.

>up
Control Room
You've never been here before, but you know exactly where you are. Here, near the top of an intimidating tower at the center of the facility, is the control room. Even before you were locked up, these sparkling achievements of technological advancement were known to you; they are admired by many outside of the facility (and even some inside it).

As the door swings shut behind you, all ambient sound is abruptly cut off. The lack of blaring alarms is deafening. In the center of the room, an elaborate panel with neat rows of buttons, switches, and keypads provides more illumination than the emergency lights overhead. Attached to it, like an obscenely large laptop, is a screen wider than your armspan.

On the west and north walls are metal doors.

>n
Secret Hall
The hallway winds downward for ages. Eventually, you arrive at the entrance to a tunnel, similar to the one you took to get to the tower. The tunnel continues to the east.

>e
Secret Tunnel
For a while longer, you walk east. You don't know where this tunnel leads, or what your fate will be when you get there. Lost in musings, and no longer feeling hurried, you don't see the ladder until you're practically right in front of it. The ladder goes upward.

>up
Freedom
You ascend out of the tunnel and are overcome with emotion. This is it. The first air you've breathed outside the prison for years. Above, a few stars poke through gloomy clouds. Behind you, tall concrete walls obscure all of the prison except the control tower, which rises elegantly upward. Ahead, a few sets of barely visible tire tracks cut through scraggly grass, and a grove of trees stands in silhouette in the distance.

Before you take your first step out of the stairway and onto firm ground, you're blinded by a spotlight from above. Squinting, and ears still ringing from the emergency alarms, you see a helicopter hovering overhead, eerily silent. As your eyes adjust, two trucks barrel toward you. Guards leap out, their boots crunching over grass which is sharply illuminated in a circle around you. Gloved hands grab your arms.

A pins-and-needles feeling envelopes you, and your vision goes dark.

I beg your pardon?

>look
Control Room
You've never been here before, but you know exactly where you are. Here, near the top of an intimidating tower at the center of the facility, is the control room. Even before you were locked up, these sparkling achievements of technological advancement were known to you; they are admired by many outside of the facility (and even some inside it).

As the door swings shut behind you, all ambient sound is abruptly cut off. The lack of blaring alarms is deafening. In the center of the room, an elaborate panel with neat rows of buttons, switches, and keypads provides more illumination than the emergency lights overhead. Attached to it, like an obscenely large laptop, is a screen wider than your armspan.

On the west and north walls are metal doors.

>w
Staircase
The top of a short staircase. Further down, you suspect you'll reach the facility chapel.

>down
Chapel Annex
I didn't get around to this room haha. Go north.

>n
Chapel
You haven't been religious in a long time. During timeslots when most other prisoners are attending services, you angle for the better-paying data mine positions. It never hurts to have some extra credits on hand for unplanned phone calls or dessert at the mess hall.

Today though, despite the simplicity of the building, its underwhelming non-denominational altar, and the red light bathing everything, you feel comforted. You sit in a pew near the front, aware that you might never find your way out of this place. Rage is replaced by a hollow calmness.

You barely notice the main doors to the chapel slam open behind you, and you sit stoically as bright lights strobe over the room and guards stream in, holding down the perimeter. Someone grabs your arms and drags you backwards.

A pins-and-needles feeling envelopes you, and your vision goes dark.

>look
Visitation
Although it's as cold and empty as the rest of the facility right now, and looks foreboding under the red light, this room is the only one that can be downright joyous at times. Here, you can greet friends and family, even if the pane of polished glass bisecting the room prevents real contact. The pane is dotted with two-way speakers, separated by plastic dividers for a measly amount of privacy.

A door at the southeast, with a check-in machine next to it, leads to the phone bank (which is much more familiar to you than visitation). And although it's normally locked, the door in the glass divider hangs open, giving you access to two more doors on the northeast and northwest walls.

* * *

>n
Intersection
Here, the narrow central hall of your cell's wing meets a wider corridor. The alarms are still blaring, and the light still dim, but you've been this way before (albeit under close supervision). The corridor runs from east to west, and though you can't see far in either direction, you don't hear or see anyone else.

>w
Corridor (west)
A wider hall with an arched ceiling. This is where you pass through regularly to get to other parts of the facility, so despite the lack of light you can navigate it easily. On the north wall is the entrance to a small alcove. After that, corridor curves around slightly, ending at an unassuming door to the northwest.

>n
Alcove
This cramped room, if you can even call it that, overlooks the facility's yard. The sun set long ago, but the emergency lights on building exteriors illuminate it plenty. From here, you can see the east and west wings of the building, which face each other. Combined with the south wing, which you are in right now, the whole facility forms a U-shape. The yard is enclosed within this shape, and in its center stands the simple yet elegant control tower.

Leaning against the wall of the alcove is a hatchet, and the archway south of you leads back into the corridor.

>take hatchet
Taken.

>nw
You can't go that way.

>s
Corridor (west)

>nw
Waiting Room
You've sat in the neat rows of seats many times, waiting for your shift to start in the room northwest of here. The door is locked, seeing as it's after hours, but unlike most in the facility it is a plain wooden door. No one would go in there voluntarily, so there isn't much danger of break-ins.

>break door with hatchet
It takes several chops, but slowly you're able to hack through the door (at least, enough to fit through its splintered remains).

>nw
Data Mining
This is where you've spent most of your out-of-cell time. Sleek white booths are installed around the perimeter of the room. All of them are locked shut; they are kept under tight control during off hours. cameras are embedded in each corner, and blink in the same familiar way as the one in your cell.

A spiral staircase leads up to a wide balcony that rings the room high above. You've only been to the second floor a few times, but you know there's an exit there that guards come and go from. Back on ground level, a heavy-looking door in the north wall marks another exit.

You can see a wooden door here.

>u
Data Mining (second floor)
There are a few empty guard posts here, normally ensuring that the prisoners below stay in line. The second floor is essentially just a balcony, but to the northeast of the part you're on now, a catwalk spans over the center.

>d
A strange impulse tells you not to go that way.

>ne
Catwalk (Data Mining)
You stride quickly across the catwalk to the opposite side of the second floor, not bothering to look down. It continues to the northeast, entering an area outside of the data mining center. You keep following it until you reach a breathtaking view.

Here, the catwalk emerges from the wall of the facility, and connects to a great network of catwalks traversing the space above the central yard. The one you're on runs northeast, straight across the expanse to the facility's central control tower.

>ne
Catwalk (above the yard))
The catwalk is narrow and creaky. Far below, the yard is deserted, lit by emergency lights on the exterior of the facility and the control tower. Branching off of the catwalk to the west is a small platform. To the northeast is the control tower.

>w
Turret
This small balcony is attached precariously to the catwalk, and houses a deadly-looking weapons system. It's turned off, but you've seen it used before when there's any sign of trouble in the yard. When the guards are having a good day, they'll set it to stun. The catwalk meets up with this platform on the east side.

>e
Catwalk (above the yard))

>ne
Control Tower
This is it, the literal and metaphorical center of the facility. All polished glass and shiny metal, with catwalks jutting out at odd angles. The heavy door in front of you doesn't budge when you try it, but one seems to be standing slightly ajar a few floors below. No doubt the work of some hasty guard. It looks like there's a route down, if you drop from catwalk to catwalk without falling to your death.

>d
You drop to the first catwalk below without much difficulty. The next one takes a bit of a swinging leap, and with the final drop you feel a sharp pain in your ankle. Nevertheless, this might be your best chance to get out, and you step through the door, closing it behind you.

Control Room
You've never been here before, but you know exactly where you are. Here, near the top of an intimidating tower at the center of the facility, is the control room. Even before you were locked up, these sparkling achievements of technological advancement were known to you; they are admired by many outside of the facility (and even some inside it).

As the door swings shut behind you, all ambient sound is abruptly cut off. The lack of blaring alarms is deafening. In the center of the room, an elaborate panel with neat rows of buttons, switches, and keypads provides more illumination than the emergency lights overhead. Attached to it, like an obscenely large laptop, is a screen wider than your armspan.

On the west and north walls are metal doors.

>u
Control Tower

>d
You drop to the first catwalk below without much difficulty. The next one takes a bit of a swinging leap, and with the final drop you feel a sharp pain in your ankle. Nevertheless, this might be your best chance to get out, and you step through the door, closing it behind you.

Control Room
You can see a panel and a screen here.

>w
Staircase
The top of a short staircase. Further down, you suspect you'll reach the facility chapel.

>e
A strange impulse tells you not to go that way.

>d
Chapel Annex
I didn't get around to this room haha. Go north.

>n
Chapel
You haven't been religious in a long time. During timeslots when most other prisoners are attending services, you angle for the better-paying data mine positions. It never hurts to have some extra credits on hand for unplanned phone calls or dessert at the mess hall.

Today though, despite the simplicity of the building, its underwhelming non-denominational altar, and the red light bathing everything, you feel comforted. You sit in a pew near the front, aware that you might never find your way out of this place. Rage is replaced by a hollow calmness.

You barely notice the main doors to the chapel slam open behind you, and you sit stoically as bright lights strobe over the room and guards stream in, holding down the perimeter. Someone grabs your arms and drags you backwards.

A pins-and-needles feeling envelopes you, and your vision goes dark.

I beg your pardon?

>?
Control Room
You've never been here before, but you know exactly where you are. Here, near the top of an intimidating tower at the center of the facility, is the control room. Even before you were locked up, these sparkling achievements of technological advancement were known to you; they are admired by many outside of the facility (and even some inside it).

As the door swings shut behind you, all ambient sound is abruptly cut off. The lack of blaring alarms is deafening. In the center of the room, an elaborate panel with neat rows of buttons, switches, and keypads provides more illumination than the emergency lights overhead. Attached to it, like an obscenely large laptop, is a screen wider than your armspan.

On the west and north walls are metal doors.

>w
A strange impulse tells you not to go that way.

>n
Secret Hall
The hallway winds downward for ages. Eventually, you arrive at the entrance to a tunnel. The walls are rough stone, and it is just tall enough to stand without hunching over. Over the years, names and symbols have been gouged into the walls by bored facility guards. The tunnel continues to the east.

>e
Secret Tunnel
For a while longer, you walk east. You don't know where this tunnel leads, or what your fate will be when you get there. Lost in musings, and no longer feeling hurried, you don't see the ladder until you're practically right in front of it. The ladder goes upward.

* * *

>uh oh
Data Mining
This is where you've spent most of your out-of-cell time. Sleek white booths are installed around the perimeter of the room. All of them are locked shut; they are kept under tight control during off hours. cameras are embedded in each corner, and blink in the same familiar way as the one in your cell.

A spiral staircase leads up to a wide balcony that rings the room high above. You've only been to the second floor a few times, but you know there's an exit there that guards come and go from. Back on ground level, a heavy-looking door in the north wall marks another exit.

You can see a wooden door here.

>n
Trackway (south)
Here, a small platform sits at the side of an indoor tunnel. tracks for the security cars extend north. This system loops around the facility, and guards can access most important rooms from it; right now the tracks are safe to walk on, as the cars only run at certain hours.

>n
Trackway (north)
Although the tracks continue past this point, the west wall has another platform, which opens out to where you really want to go.

>w
Vehicle Bay
You step tentatively through the doorway. This is a vast covered parking lot, dotted with plug-in spots for cars. Family and friends arrive here when they have scheduled visitations with prisoners. You scan the area, stomach slowly sinking further and further as you confirm the worst: there are no vehicles that you could use to make a getaway.

Then, over the sound of the alarms, you hear an engine roar growing louder. A headlight precedes a motorcycle, and then another, and then another.

"Hey, look!" a voice echoes around the lot, and before you know it the motorcycles are in front of you, three guards are dismounting, and you're being wrestled to the ground.

A pins-and-needles feeling envelopes you, and your vision goes dark.

>look
Intersection
Here, the narrow central hall of your cell's wing meets a wider corridor. The alarms are still blaring, and the light still dim, but you've been this way before (albeit under close supervision). The corridor runs from east to west, and though you can't see far in either direction, you don't hear or see anyone else.

>w
A strange impulse tells you not to go that way.

>e
Corridor (east)
A wider hall with an arched ceiling. This is where you pass through regularly to get to other parts of the facility, so despite the lack of light you can navigate it easily. On the south wall, there is a small door that you have walked past often but never entered. The corridor continues to the east.

* * *

>s
Storage Room
Dark and cluttered. Most of the boxes here are sealed; you probably shouldn't waste time looking through them. A ladder stands in the corner. On top of a pile of junk, there is one open box. The storage room's door is in the north wall.

>take screwdrivaer
Taken.

>i'
That's not a verb I recognise.

>i
You are carrying:
  a screwdriver
  a hatchet

>take ladder
Taken.

>n
Corridor (east)

* * *

>se
Phone Room

>nw
Visitation
You can see a speakers and a check-in machine here.

>ne
Hall3
Yay more undefined rooms. Go north from here.

>n
Power Source
The lights here are so far overhead and so sparse that the room is barely navigable. It seems very quiet and still, other than the constant alarms, and the various machines that generate power for the facility don't seem to be functioning. It confirms what you thought from the beginning: this must be a power outage. There are doors to the northeast and west.

>ne
Sorry, but this area is still under construction. Unfortunately, this means that you might not have major choices for a decent section of the game, depending on the path you took to get here. Hopefully it's still enjoyable!

>w
Hallway
This hallway heads west, toward the center of the facility. It ends at a doorway that leads west. Through it, you can feel a cool breeze.

>w
Yard (east)
The facility yard. This is where recreation takes place, though you haven't come through the main entrance for prisoners. Usually, the amount of credits you'd need to spend on rec slots is infuriating, but tonight the breath of fresh air is free. You stand against the facility wall, staying out of the better-lit yard area.

This section is fenced off, but you could definitely climb the chain-link to the west. Beyond that, it would be a clean dash to the main entrance of the facility. Now you just have to step away from the wall.

>w
Yard (west)
Heart pounding, you dash away from the relative cover of the wall. You reach the chain-link fence that partitions the yard and start climbing easily enough. You're only halfway up when a floodlight turns on, and you instinctively shield your eyes.

Rapid footsteps thud toward you from several directions. By the time you lower your hand, guards are yanking you down and you land painfully on the ground. Heavy boots fill your field of vision.

A pins-and-needles feeling envelopes you, and your vision goes dark.

>n
Memory Bank
The room is bright and expansive, lined wall-to-wall with server stacks. Its sole occupant, a disheveled late-shift worker, is sitting between the stacks taking a nap. A pleasant chime from the overhead speakers jolts him awake.

"Done already? Good girl," he mutters, patting the nearest machine. He scratches his mostly bald head, then makes his way to a desk in one corner.

Sitting in front of a portly computer, he drags a new file labeled "Power Outage" to the "Simulations" folder. Briefly consulting a to-do list, he searches through the computer with rapid keystrokes, then hits enter with a bit of flair.

"Earthquake simulation initialized," a pleasant robotic voice says over the speakers. The man plods back to the stacks and resumes his nap.

I beg your pardon?

>look
    *** The End ***

Would you like to RESTART, RESTORE a saved game, QUIT or UNDO the last command?

Please give one of the answers above.

Would you like to RESTART, RESTORE a saved game, QUIT or UNDO the last command?

>um
Please give one of the answers above.

Would you like to RESTART, RESTORE a saved game, QUIT or UNDO the last command?

* * *

>w
Corridor (west)
A wider hall with an arched ceiling. This is where you pass through regularly to get to other parts of the facility, so despite the lack of light you can navigate it easily. On the north wall is the entrance to a small alcove. After that, corridor curves around slightly, ending at an unassuming door to the northwest.

>nw
Waiting Room
You've sat in the neat rows of seats many times, waiting for your shift to start in the room northwest of here. The door is locked, seeing as it's after hours, but unlike most in the facility it is a plain wooden door. No one would go in there voluntarily, so there isn't much danger of break-ins.

>se
Corridor (west)

>n
Alcove
This cramped room, if you can even call it that, overlooks the facility's yard. The sun set long ago, but the emergency lights on building exteriors illuminate it plenty. From here, you can see the east and west wings of the building, which face each other. Combined with the south wing, which you are in right now, the whole facility forms a U-shape. The yard is enclosed within this shape, and in its center stands the simple yet elegant control tower.

Leaning against the wall of the alcove is a hatchet, and the archway south of you leads back into the corridor.

* * *

>take hatchet
Taken.

>s
Corridor (west)

>nw
Waiting Room
You can see a seats and a wooden door here.

>break door with hatchet
It takes several chops, but slowly you're able to hack through the door (at least, enough to fit through its splintered remains).

* * *

>x booth
You can't see any such thing.

>x booths
In these booths, the prisoners" most important work takes place. Although they are locked right now, their interiors are almost ingrained in your sense memory.

Each is equipped with a hardbacked chair facing a large screen. Like the photobooths from your childhood, but more sinister. From a control room who knows where, you are assigned a task for the next few hours. When you're lucky, you might be categorizing images of road signs or transcribing handwritten diary entries. When you're unlucky... well, it's no good to dwell on the videos that have been etched into your conscience from those screens. You already see them when you try to sleep at night.

>n
Trackway (south)
Here, a small platform sits at the side of an indoor tunnel. tracks for the security cars extend north. This system loops around the facility, and guards can access most important rooms from it; right now the tracks are safe to walk on, as the cars only run at certain hours.

* * *

>p
Data Mining
This is where you've spent most of your out-of-cell time. Sleek white booths are installed around the perimeter of the room. All of them are locked shut; they are kept under tight control during off hours. cameras are embedded in each corner, and blink in the same familiar way as the one in your cell.

A spiral staircase leads up to a wide balcony that rings the room high above. You've only been to the second floor a few times, but you know there's an exit there that guards come and go from. Back on ground level, a heavy-looking door in the north wall marks another exit.

You can see a wooden door here.

That's not a verb I recognise.

I beg your pardon?

>look
Data Mining
This is where you've spent most of your out-of-cell time. Sleek white booths are installed around the perimeter of the room. All of them are locked shut; they are kept under tight control during off hours. cameras are embedded in each corner, and blink in the same familiar way as the one in your cell.

A spiral staircase leads up to a wide balcony that rings the room high above. You've only been to the second floor a few times, but you know there's an exit there that guards come and go from. Back on ground level, a heavy-looking door in the north wall marks another exit.

You can see a wooden door here.

* * *

>n
The cell door is locked. It cannot be opened from the inside.

>w
CorridorB

* * *

>w
CorridorC

>nw
Waiting Room

* * *

>nw
Data Mining

>l
Data Mining

>n
Tracks

>n
Tracks2

>w
Entry

>w
Vehicle Bay

>listen
Data Mining

* * *

>n
The cell door is locked. It cannot be opened from the inside.

>ne
You can't go that way.

>n
Hall2

>n
Intersection

* * *

>e
CorridorA

>e
Dead End

* * *

>n
The cell door is locked. It cannot be opened from the inside.

>nn
That's not a verb I recognise.

>n
The cell door is locked. It cannot be opened from the inside.

>x camera
The camera is your constant companion. Day in and day out, it faithfully reports your movements to whoever it is that monitors them. When you first got here, you sometimes stared at its blinking blue light all night. Now, you rarely give it a second glance.

>x cot
It has a lumpy mattress and a metal frame.

>x window
It is small and lets in little light.

>x door
Imposing, unmarked, and definitely locked.

Suddenly, the stark white light in the ceiling flickers out. The cell is pitch-black at first, but you can clearly hear the grating sound that your cell door makes when it retracts upward. The cooler air from the hall outside floods in.

Just as your eyes begin to adjust, an eerie red emergency light fades up. The dim light confirms what you heard and felt: the door is open. Above it, the camera blinks back on, and glimmers tauntingly as you stare at it.

You register a blaring alarm sound that must have started sometime in the past minute, but otherwise the facility is deathly still. This is your chance to escape.

>n
Hall1

* * *

>x camera
The camera is your constant companion. Day in and day out, it faithfully reports your movements to whoever it is that monitors them. When you first got here, you sometimes stared at its blinking blue light all night. Now, you rarely give it a second glance.

>x door
Imposing, unmarked, and definitely locked.

>x window
It is small and lets in little light.

>look
Cell
This room is depressingly familiar. You've paced across every inch of the cold gray concrete, stood on tiptoes to see out of the barred window, tossed and turned under the thin blanket on your cot. A small camera is embedded above the locked cell door on the north wall.

Suddenly, the stark white light in the ceiling flickers out. The cell is pitch-black at first, but you can clearly hear the grating sound that your cell door makes when it retracts upward. The cooler air from the hall outside floods in.

Just as your eyes begin to adjust, an eerie red emergency light fades up. The dim light confirms what you heard and felt: the door is open. Above it, the camera blinks back on, and glimmers tauntingly as you stare at it.

You register a blaring alarm sound that must have started sometime in the past minute, but otherwise the facility is deathly still. It must be a power outage, or worse. Whatever the case, this is your chance to escape.

>n
South Hall
The hall is flooded with red light and the sound of alarms. Your cell is one of many cells that branches off of it, and every door down the length of the hall is now open. To the south, you know there are branching hallways that lead deeper into this wing of the facility, and to the north is the main corridor that runs through the complex.

>s
It would be unwise to stay in this area. Guards will arrive soon to lock it down, as it has the highest concentration of prisoners.

>n
Intersection
Here, the narrow central hall of your cell's wing meets a wider corridor. The alarms are still blaring, and the light still dim, but you've been this way before (albeit under close supervision). The corridor runs from east to west, and though you can't see far in either direction, you don't hear or see anyone else.

* * *

>n
Alcove
This cramped room, if you can even call it that, overlooks the facility's yard. The sun set long ago, but the emergency lights on building exteriors illuminate it plenty. From here, you can see the east and west wings of the building, which face each other. Combined with the south wing, which you are in right now, the whole facility forms a U-shape. The yard is enclosed within this shape, and in its center stands the simple yet elegant control tower.

Leaning against the wall of the alcove is a hatchet, and the archway south of you leads back into the corridor.

>s
Corridor (west)
A wider hall with an arched ceiling. This is where you pass through regularly to get to other parts of the facility, so despite the lack of light you can navigate it easily. On the north wall is the entrance to a small alcove. After that, corridor curves around slightly, ending at an unassuming door to the northwest.

>nw
Waiting Room
You've sat in the neat rows of seats many times, waiting for your shift to start in the room northwest of here. The door is locked, seeing as it's after hours, but unlike most in the facility it is a plain wooden door. No one would go in there voluntarily, so there isn't much danger of break-ins.

>nw
The wooden door stands in your way

>break wooden door with hatchet
You can't see any such thing.

>break wooden door
You can't exactly punch through with your bare fist.

>se
Corridor (west)
A wider hall with an arched ceiling. This is where you pass through regularly to get to other parts of the facility, so despite the lack of light you can navigate it easily. On the north wall is the entrance to a small alcove. After that, corridor curves around slightly, ending at an unassuming door to the northwest.

>se
You can't go that way.

>n
Alcove
This cramped room, if you can even call it that, overlooks the facility's yard. The sun set long ago, but the emergency lights on building exteriors illuminate it plenty. From here, you can see the east and west wings of the building, which face each other. Combined with the south wing, which you are in right now, the whole facility forms a U-shape. The yard is enclosed within this shape, and in its center stands the simple yet elegant control tower.

Leaning against the wall of the alcove is a hatchet, and the archway south of you leads back into the corridor.

* * *

>take hatchet
Taken.

>s
Corridor (west)
A wider hall with an arched ceiling. This is where you pass through regularly to get to other parts of the facility, so despite the lack of light you can navigate it easily. On the north wall is the entrance to a small alcove. After that, corridor curves around slightly, ending at an unassuming door to the northwest.

* * *

>nw
Waiting Room
You've sat in the neat rows of seats many times, waiting for your shift to start in the room northwest of here. The door is locked, seeing as it's after hours, but unlike most in the facility it is a plain wooden door. No one would go in there voluntarily, so there isn't much danger of break-ins.

>x door
A wooden door painted blue, outfitted with a heavy metal bolt. You could probably break it with the right implement.

>break wooden door with hatchet
It takes several chops, but slowly you're able to hack through the door (at least, enough to fit through its splintered remains).

>nw
Data Mining
This is where you've spent most of your out-of-cell time. Sleek white booths are installed around the perimeter of the room. All of them are locked shut; they are kept under tight control during off hours. cameras are embedded in each corner, and blink in the same familiar way as the one in your cell.

A spiral staircase leads up to a wide balcony that rings the room high above. You've only been to the second floor a few times, but you know there's an exit there that guards come and go from. Back on ground level, a heavy-looking door in the north wall marks another exit.

You can see a wooden door here.

>up
Data Mining (second floor)
There are a few empty guard posts here, normally ensuring that the prisoners below stay in line. The second floor is essentially just a balcony, but to the northeast of the part you're on now, a catwalk spans over the center.

>ne
Catwalk (Data Mining)
You stride quickly across the catwalk to the opposite side of the second floor, not bothering to look down. It continues to the northeast, entering an area outside of the data mining center. You keep following it until you reach a breathtaking view.

Here, the catwalk emerges from the wall of the facility, and connects to a great network of catwalks traversing the space above the central yard. The one you're on runs northeast, straight across the expanse to the facility's central control tower.

* * *

>w
Turret
This small balcony is attached precariously to the catwalk, and houses a deadly-looking weapons system. It's turned off, but you've seen it used before when there's any sign of trouble in the yard. When the guards are having a good day, they'll set it to stun. The catwalk meets up with this platform on the east side.

>e
Catwalk (above the yard))
The catwalk is narrow and creaky. Far below, the yard is deserted, lit by emergency lights on the exterior of the facility and the control tower. Branching off of the catwalk to the west is a small platform. To the northeast is the control tower.

>ne
Control Tower
This is it, the literal and metaphorical center of the facility. All polished glass and shiny metal, with catwalks jutting out at odd angles. The heavy door in front of you doesn't budge when you try it, but one seems to be standing slightly ajar a few floors below. No doubt the work of some hasty guard. It looks like there's a route down, if you drop from catwalk to catwalk without falling to your death.

>down
You drop to the first catwalk below without much difficulty. The next one takes a bit of a swinging leap, and with the final drop you feel a sharp pain in your ankle. Nevertheless, this might be your best chance to get out, and you step through the door, closing it behind you.

Control Room
You've never been here before, but you know exactly where you are. Here, near the top of an intimidating tower at the center of the facility, is the control room. Even before you were locked up, these sparkling achievements of technological advancement were known to you; they are admired by many outside of the facility (and even some inside it).

As the door swings shut behind you, all ambient sound is abruptly cut off. The lack of blaring alarms is deafening. In the center of the room, an elaborate panel with neat rows of buttons, switches, and keypads provides more illumination than the emergency lights overhead. Attached to it, like an obscenely large laptop, is a screen wider than your armspan.

On the west and north walls are metal doors.

>n
Secret Hall

>n
You can't go that way.

>721
That's not a verb I recognise.

>n
You can't go that way.

>s
Control Room
You've never been here before, but you know exactly where you are. Here, near the top of an intimidating tower at the center of the facility, is the control room. Even before you were locked up, these sparkling achievements of technological advancement were known to you; they are admired by many outside of the facility (and even some inside it).

As the door swings shut behind you, all ambient sound is abruptly cut off. The lack of blaring alarms is deafening. In the center of the room, an elaborate panel with neat rows of buttons, switches, and keypads provides more illumination than the emergency lights overhead. Attached to it, like an obscenely large laptop, is a screen wider than your armspan.

On the west and north walls are metal doors.

>x screen
You can't access anything without a passcode, which you of course don't know. The "sleep" screen of this overgrown computer is an abstracted map of the facility, scattered with rooms, halls, and doors with little numbers next to them.
Intriguingly, the yard seems to be criss-crossed with paths that don't correspond to the catwalks.

* * *

>take camera
You can't reach it, and anyway it's fixed in place.

>take blanket
That's fixed in place.

>take cot
That's fixed in place.

>take window
That's fixed in place.

>listen
Suddenly, the stark white light in the ceiling flickers out. The cell is pitch-black at first, but you can clearly hear the grating sound that your cell door makes when it retracts upward. The cooler air from the hall outside floods in.

Just as your eyes begin to adjust, an eerie red emergency light fades up. The dim light confirms what you heard and felt: the door is open. Above it, the camera blinks back on, and glimmers tauntingly as you stare at it.

You register a blaring alarm sound that must have started sometime in the past minute, but otherwise the facility is deathly still. This is your chance to escape.

>take door
That's fixed in place.

* * *

>x cot
It has a lumpy mattress and a metal frame.

>x camera
The camera is your constant companion. Day in and day out, it faithfully reports your movements to whoever it is that monitors them. When you first got here, you sometimes stared at its blinking blue light all night. Now, you rarely give it a second glance.

>x blanket
Light blue linen. You make the bed neatly every day, for lack of anything better to do.

>x window
It is small and lets in little light.

>n
The cell door is locked. It cannot be opened from the inside.

Suddenly, the stark white light in the ceiling flickers out. The cell is pitch-black at first, but you can clearly hear the grating sound that your cell door makes when it retracts upward. The cooler air from the hall outside floods in.

Just as your eyes begin to adjust, an eerie red emergency light fades up. The dim light confirms what you heard and felt: the door is open. Above it, the camera blinks back on, and glimmers tauntingly as you stare at it.

You register a blaring alarm sound that must have started sometime in the past minute, but otherwise the facility is deathly still. This is your chance to escape.

>n
Hall1

* * *

>x door
Imposing, unmarked, and definitely locked.

>x cot
It has a lumpy mattress and a metal frame.

>x blankets
Light blue linen. You make the bed neatly every day, for lack of anything better to do.

>x camera
The camera is your constant companion. Day in and day out, it faithfully reports your movements to whoever it is that monitors them. When you first got here, you sometimes stared at its blinking blue light all night. Now, you rarely give it a second glance.

>take camera
You can't reach it, and anyway it's fixed in place.

Suddenly, the stark white light in the ceiling flickers out. The cell is pitch-black at first, but you can clearly hear the grating sound that your cell door makes when it retracts upward. The cooler air from the hall outside floods in.

Just as your eyes begin to adjust, an eerie red emergency light fades up. The dim light confirms what you heard and felt: the door is open. Above it, the camera blinks back on, and glimmers tauntingly as you stare at it.

You register a blaring alarm sound that must have started sometime in the past minute, but otherwise the facility is deathly still. This is your chance to escape.