Challenge1
An Interactive Fiction by Tulasi Holdridge
Release 1 / Serial number 200701 / Inform 7 build 6M62 (I6/v6.34 lib 6/12N) SD

Cliffside house
A small cottage with stone walls and a warm interior. In the center of the room is a table with a chair. A piece of paper lies on the table. A door leads outside.

>go outside
Terrace
This is a simple balcony with a quite low railing. Below there is a short cliff-like drop, and then a rolling meadow with a path leading south to a village. You could jump down to the meadow fairly easily.

>down
Meadow Path
A serene but uninteresting meadow. A footpath cuts through it. At the south end of the path is a small village, and at the north end is a short cliff, maybe a couple meters high. On top of the cliff is a cozy cottage.

>s
Village
A quaint collection of cottages and shops. You can enter the grocery store on the east side, or follow the meadow path to the north.

>e
Grocery Store
Stocked with basic essentials like bread and milk. There's a side door on the south wall, and the main entrance is on the west side.

>s
Side Alley
An uninteresting alley. There is a ladder slightly taller than you leaning against a wall.

>take ladder
Taken.

>n
Grocery Store
Stocked with basic essentials like bread and milk. There's a side door on the south wall, and the main entrance is on the west side.

>e
You can't go that way.

>w
Village
A quaint collection of cottages and shops. You can enter the grocery store on the east side, or follow the meadow path to the north.

>n
Meadow Path
A serene but uninteresting meadow. A footpath cuts through it. At the south end of the path is a small village, and at the north end is a short cliff, maybe a couple meters high. On top of the cliff is a cozy cottage.

>put ladder next to cliff
I didn't understand that sentence.

* * *

>go outside
Terrace
This is a simple balcony with a quite low railing. Below there is a short cliff-like drop, and then a rolling meadow with a path leading south to a village. You could jump down to the meadow fairly easily.

>jump down
I only understood you as far as wanting to jump.

* * *

Challenge1
An Interactive Fiction by Tulasi Holdridge
Release 1 / Serial number 200701 / Inform 7 build 6M62 (I6/v6.34 lib 6/12N) SD

Cliffside house
A small cottage with stone walls and a warm interior. In the center of the room is a table with a chair. A piece of paper lies on the table. A door leads outside.

>take paper
Taken.

>wear sneakers
(first taking the pair of sneakers)
You put on the pair of sneakers.

>go outside
Terrace
This is a simple balcony with a quite low railing. Below and to the south, there is a short cliff-like drop, and then a rolling meadow with a path leading further south to a village. You could jump down to the meadow fairly easily.

>s
You step over the short railing and drop down into the meadow, landing in a crouch.

>s
You can't go that way.

>l
Meadow Path
A serene but uninteresting meadow. A footpath cuts through it. At the south end of the path is a small village, and at the north end is a short cliff, maybe a couple meters high. On top of the cliff is a cozy cottage.

This is a simple balcony with a quite low railing. Below and to the south, there is a short cliff-like drop, and then a rolling meadow with a path leading further south to a village. You could jump down to the meadow fairly easily.

* * *

Challenge1
An Interactive Fiction by Tulasi Holdridge
Release 1 / Serial number 200701 / Inform 7 build 6M62 (I6/v6.34 lib 6/12N) SD

Cliffside house
A small cottage with stone walls and a warm interior. In the center of the room is a table with a chair. A piece of paper lies on the table. A door leads outside.

>verbose
Challenge1 is now in its "verbose" mode, which always gives long descriptions of locations (even if you've been there before).

>x paper
A To-Do list with one item: "Buy groceries in the village."

>go outside
Terrace
This is a simple balcony with a quite low railing. Below and to the south, there is a short cliff-like drop, and then a rolling meadow with a path leading further south to a village. You could jump down to the meadow fairly easily.

>go south
You step over the short railing and drop down into the meadow, landing in a crouch.

>go inside
You can't go that way.

>wear sneakers
You can't see any such thing.

>go outside
You can't go that way.

>go inside
You can't go that way.

>go outside
You can't go that way.

>s
You can't go that way.

>i
You are carrying nothing.

* * *

Challenge1
An Interactive Fiction by Tulasi Holdridge
Release 1 / Serial number 200701 / Inform 7 build 6M62 (I6/v6.34 lib 6/12N) SD

Cliffside house
A small cottage with stone walls and a warm interior. In the center of the room is a table with a chair. A piece of paper lies on the table. A door leads outside.

>x paper
A To-Do list with one item: "Buy groceries in the village."

>take paper
Taken.

>go outside
Terrace
This is a simple balcony with a quite low railing. Below and to the south, there is a short cliff-like drop, and then a rolling meadow with a path leading further south to a village. You could jump down to the meadow fairly easily.

>go south
Meadow Path
A serene but uninteresting meadow. A footpath cuts through it. At the south end of the path is a small village, and at the north end is a short cliff, maybe a couple meters high. On top of the cliff is a cozy cottage.

You can see a cliff here.

>go inside
You can't go that way.

* * *

>go outside
You can't go that way.

>south
You can't go that way.

>i
You are carrying:
  a paper

* * *

>go outside
Terrace
This is a simple balcony with a quite low railing. Below and to the south, there is a short cliff-like drop, and then a rolling meadow with a path leading further south to a village. You could jump down to the meadow fairly easily.

>s
Meadow Path
A serene but uninteresting meadow. A footpath cuts through it. At the south end of the path is a small village, and at the north end is a short cliff, maybe a couple meters high. On top of the cliff is a cozy cottage.

>n
The cliff is just barely too tall for you to clamber up!

>s
Village
A quaint collection of cottages and shops. You can enter the grocery store on the east side, or follow the meadow path to the north.

* * *

>e
Grocery Store
Stocked with basic essentials like bread and milk. There's a side door on the south wall, and the main entrance is on the west side.

>take bread
Taken.

>take milk
Taken.

>s
Side Alley
An uninteresting alley. There is a ladder slightly taller than you leaning against a wall.

* * *

>n
Grocery Store
Stocked with basic essentials like bread and milk. There's a side door on the south wall, and the main entrance is on the west side.

>w
Village
A quaint collection of cottages and shops. You can enter the grocery store on the east side, or follow the meadow path to the north.

* * *

>n
Meadow Path
A serene but uninteresting meadow. A footpath cuts through it. At the south end of the path is a small village, and at the north end is a short cliff, maybe a couple meters high. On top of the cliff is a cozy cottage.

>place ladder against cliff
That's not a verb I recognise.

>place ladder on cliff
That's not a verb I recognise.

>put ladder on cliff
Putting things on the cliff would achieve nothing.

* * *

Challenge1
An Interactive Fiction by Tulasi Holdridge
Release 1 / Serial number 200701 / Inform 7 build 6M62 (I6/v6.34 lib 6/12N) SD

Cliffside house
A small cottage with stone walls and a warm interior. In the center of the room is a table with a chair. A piece of paper lies on the table. A door leads outside.

>x table
It is a simple, sturdy-looking wood table. In the center is a piece of paper with "To-Do List" scrawled at the top.

>take paper
Taken.

>x chair
It is a wood chair with a high back.

>go outside
Terrace
This is a simple balcony with a quite low railing. Below there is a short cliff-like drop, and then a rolling meadow with a path leading south to a village. You could jump down to the meadow fairly easily.

* * *

>down
Meadow Path
A serene but uninteresting meadow. A footpath cuts through it. At the south end of the path is a small village, and at the north end is a short cliff, maybe a couple meters high. On top of the cliff is a cozy cottage.

>s
Village
A quaint collection of cottages and shops. You can enter the grocery store on the east side, or follow the meadow path north.

>e
Grocery Store
Stocked with basic essentials like bread and milk. The main entrance is on the west wall.

>take bread
Taken.

* * *

>take milk
Taken.

>x milk
You see nothing special about milk.

>w
Village
A quaint collection of cottages and shops. You can enter the grocery store on the east side, or follow the meadow path north.

>n
Meadow Path
A serene but uninteresting meadow. A footpath cuts through it. At the south end of the path is a small village, and at the north end is a short cliff, maybe a couple meters high. On top of the cliff is a cozy cottage.

>n
You can't go that way.

>up
The cliff is just barely too tall for you to clamber over.

* * *

>x table
It is a simple, sturdy-looking wood table. In the center is a piece of paper with "To-Do List" scrawled at the top.

>x chair
It is a wood chair with a high back.

>x paper
A To-Do list with one item: "Buy groceries in the village."

* * *

>take paper
Taken.

>go outside
Terrace
This is a simple balcony with a quite low railing. Below there is a short cliff-like drop, and then a rolling meadow with a path leading south to a village. You could jump down to the meadow fairly easily.

>go south
You can't go that way.

>down
Meadow Path
A serene but uninteresting meadow. A footpath cuts through it. At the south end of the path is a small village, and at the north end is a short cliff, maybe a couple meters high. On top of the cliff is a cozy cottage.

>north
You can't go that way.

>up
The cliff is just barely too tall for you to clamber over.

* * *

>x table
It is a simple, sturdy-looking wood table. In the center is a piece of paper with "To-Do List" scrawled at the top.

>x paper
A To-Do list with one item: "Buy groceries in the village."

* * *

>take paper
Taken.

>take table
That's fixed in place.

>take chair
That's fixed in place.

>x chair
It is a wood chair with a high back.

>x sneakers
White shoes with blue laces. They appear to be your size.

>wear sneakers
(first taking the pair of sneakers)
You put on the pair of sneakers.

>undo
Cliffside house
[Previous turn undone.]

>i
You are carrying:
  a paper

* * *

>x sneakers
White shoes with blue laces. They appear to be your size.

>go outside
Terrace
This is a simple balcony with a quite low railing. Below, there is a short cliff-like drop, and then a rolling meadow with a path leading south to a village. You could jump down to the meadow fairly easily.

>jump down
I only understood you as far as wanting to jump.

>go down
The drop looks safe, but you might want to put on some shoes before going out into the world.

>go inside
Cliffside house
You can see a table, a chair and a pair of sneakers here.

>wear sneakers
(first taking the pair of sneakers)
You put on the pair of sneakers.

>verbose
Challenge1 is now in its "verbose" mode, which always gives long descriptions of locations (even if you've been there before).

>go outsid
You can't see any such thing.

>go outside
Terrace
This is a simple balcony with a quite low railing. Below, there is a short cliff-like drop, and then a rolling meadow with a path leading south to a village. You could jump down to the meadow fairly easily.

>go inside
Cliffside house
You can see a table and a chair here.

>go outside
Terrace
This is a simple balcony with a quite low railing. Below, there is a short cliff-like drop, and then a rolling meadow with a path leading south to a village. You could jump down to the meadow fairly easily.

>go down
The drop looks safe, but you might want to put on some shoes before going out into the world.

>i
You are carrying:
  a pair of sneakers (being worn)
  a paper