main project shell
An Interactive Fiction by Tulasi Holdridge
Release 1 / Serial number 200707 / Inform 7 build 6M62 (I6/v6.34 lib 6/12N) SD

Cell

* * *

>n
Choice1
Now at choice 1. Choice2a and Choice2b.

* * *

>ne
Choice2a
Now at choice 2a. Ending1 and Choice3a.

>ne
Ending1
You have reached ending 1.

>listen
Cell

>s
You can't go that way.

>se
You can't go that way.

>ne
You can't go that way.

>n
Choice1
Now at choice 1. Choice2a and Choice2b.

>ne
Choice2a
Now at choice 2a. Ending1 and Choice3a.

* * *

main project shell
An Interactive Fiction by Tulasi Holdridge
Release 1 / Serial number 200707 / Inform 7 build 6M62 (I6/v6.34 lib 6/12N) SD

Cell

>n
Choice1
Now at choice 1. Children: Choice2a and Choice2b. Parent: nothing.

* * *

>nw
Choice2b
Now at choice 2b. Choice3a and Choice3b.

>ne
Choice3a
Now at choice 3a. Ending2 and Ending3.

>ne
Ending2
You have reached ending 2.

>listen
Cell

* * *

>n
Choice1
Now at choice 1. Children: Choice2a and Choice2b. Parent: nothing.

>ne
Choice2a
Now at choice 2a. Children: Ending1 and Choice3a. Parent: Choice1.

>NE
Ending1
You have reached ending 1.

>listen
Choice2a
Now at choice 2a. Children: Ending1 and Choice3a. Parent: Choice1.

>nw
Choice3a
Now at choice 3a. Children: Ending2 and Ending3. Parent: Choice2a.

* * *

>ne
Ending2
You have reached ending 2.

>listen
Choice3a
Now at choice 3a. Children: Ending2 and Ending3. Parent: Choice2a.

>nw
Ending3
You have reached ending 3.

>listen
Choice1
Now at choice 1. Children: Choice2a and Choice2b. Parent: nothing.

* * *

>ne
Choice2a
Now at choice 2a. Children: Ending1 and Choice3a. Parent: Choice1.

>e
You can't go that way.

>ne
Ending1
You have reached ending 1.

* * *

>listen
Cell

>n
Choice1
Now at choice 1. Choice2a and Choice2b.

>nw
Choice2b
Now at choice 2b. Choice3b.

* * *

>ne
Choice2a
Now at choice 2a. Children: Ending1 and Choice3a. Parent: Choice1.

>ne
Ending1
You have reached ending 1.

I beg your pardon?

I beg your pardon?

* * *

>ne
Ending1
You have reached ending 1.

>listen
Choice2a
Now at choice 2a. Children: Ending1 and Choice3a. Parent: Choice1.

>n
Choice1
Now at choice 1. Children: Choice2a and Choice2b. Parent: nothing.

>nw
Choice2b
Now at choice 2b. Children: Choice3b. Parent: Choice1.

>nw
Choice3b
Now at choice 3b. Children: Ending4 and Ending5. Parent: Choice2b.

>ne
Ending4
You have reached ending 4.

>sw
Choice3b
Now at choice 3b. Children: Ending4 and Ending5. Parent: Choice2b.

>nw
Ending5
You have reached ending 5.

* * *

>listen
Choice2a
Now at choice 2a. Children: Ending1 and Choice3a. Parent: Choice1.

>ne
Sorry, you've made this choice before.

* * *

>nw
Choice3a
Now at choice 3a. Children: Ending2 and Ending3. Parent: Choice2a.

>ne
Ending2
You have reached ending 2.

* * *

>nw
Choice3a
Now at choice 3a. Children: Ending2 and Ending3. Parent: Choice2a.

>nw
Ending3
You have reached ending 3.

>listen
Choice3a
Now at choice 3a. Children: Ending2 and Ending3. Parent: Choice2a.

>ne
Ending2
You have reached ending 2.

>listen
Choice1
Now at choice 1. Children: Choice2a and Choice2b. Parent: nothing.

>nw
Choice2b
Now at choice 2b. Children: Choice3b. Parent: Choice1.

* * *

>ne
Ending4
You have reached ending 4.

>listen
Choice3b
Now at choice 3b. Children: Ending4 and Ending5. Parent: Choice2b.

>nw
Ending5
You have reached ending 5.

>listen
Choice1
Now at choice 1. Children: Choice2a and Choice2b. Parent: nothing.

* * *

>listen
Choice2a
Now at choice 2a. Children: Ending1 and Choice3a. Parent: Choice1.

>parent of Choice3a
That's not a verb I recognise.

* * *

>ne
Ending1
You have reached ending 1.

>sw
Choice2a
Now at choice 2a. Ending1 and Choice3a.

>nw
Choice3a
Now at choice 3a. Ending2 and Ending3.

>ne
Ending2
You have reached ending 2.

>sw
Choice3a
Now at choice 3a. Ending2 and Ending3.

>se
Choice2a
Now at choice 2a. Ending1 and Choice3a.

* * *

>ne
Choice2a
Now at choice 2a. Children: Ending1 and Choice3a. Parent: Choice1.

>nw
Choice3a
Now at choice 3a. Children: Ending2 and Ending3. Parent: Choice2a.

* * *

>ne
Ending2
You have reached ending 2.

>listen
Choice2a
Now at choice 2a. Children: Ending1 and Choice3a. Parent: Choice1.

>ne
Ending1
You have reached ending 1.

>listen
Choice1
Now at choice 1. Children: Choice2a and Choice2b. Parent: nothing.

* * *

>ne
Choice2a
Now at choice 2a. Children: Ending1 and Choice3a. Parent: Choice1.

>sw
Choice1
Now at choice 1.

* * *

>n
Choice1
Now at choice 1. Children: Choice2a and Choice2b. Parent: nothing.

>nw
Choice2b
Now at choice 2b. Children: Choice3a and Choice3b. Parent: Choice1.

>ne
Choice3a
Now at choice 3a. Children: Ending2 and Ending3. Parent: Choice2b.

>ne
Ending2
You have reached ending 2.

>listen
Choice3a
Now at choice 3a. Children: Ending2 and Ending3. Parent: Choice2b.

>nw
Ending3
You have reached ending 3.

>listen
Choice2b
Now at choice 2b. Children: Choice3a and Choice3b. Parent: Choice1.

>nw
Choice3b
Now at choice 3b. Children: Ending4 and Ending5. Parent: Choice2b.

* * *

>listen
Choice1
Now at choice 1. Children: Choice2a and Choice2b. Parent: nothing.

>ne
Choice2a
Now at choice 2a. Children: Ending1. Parent: Choice1.

>ne
Ending1
You have reached ending 1.

* * *

>nw
Choice2b
Now at choice 2b. Children: Choice3a and Choice3b. Parent: Choice1.

>nw
Choice3b
Now at choice 3b. Children: Ending4 and Ending5. Parent: Choice2b.

>nw
Ending5
You have reached ending 5.

>listen
Choice3b
Now at choice 3b. Children: Ending4 and Ending5. Parent: Choice2b.

>ne
Ending4
You have reached ending 4.

>listen
Choice2b
Now at choice 2b. Children: Choice3a and Choice3b. Parent: Choice1.

>ne
Choice3a
Now at choice 3a. Children: Ending2 and Ending3. Parent: Choice2b.