You stir from a short night's sleep (maybe more of a long nap). It is still the wee hours of the morning, but you can make out your surroundings in silhouette.

Challenge 3
An Interactive Fiction by Tulasi Holdridge
Release 1 / Serial number 201102 / Inform 7 build 6M62 (I6/v6.34 lib 6/12N) SD

The Field (center)
A lush expanse of tall grass interspersed with wildflowers. Your picnic blanket is spread across the ground, and standing on top is the telescope you've had for years. The telescope, as well as the woven picnic basket next to it, accumulated dew while you were asleep.

>n
The Field (north)
A patch of lavender is growing here. Further north is a dense forest, with leaves that swish in the breeze.

>s
The Field (center)
A lush expanse of tall grass interspersed with wildflowers. Your picnic blanket is spread across the ground, and standing on top is the telescope you've had for years. The telescope, as well as the woven picnic basket next to it, accumulated dew while you were asleep.

>n
The Field (north)
A patch of lavender is growing here. Further north is a dense forest, with leaves that swish in the breeze.

In your peripheral vision, a moth flits by.

>s
The Field (center)
A lush expanse of tall grass interspersed with wildflowers. Your picnic blanket is spread across the ground, and standing on top is the telescope you've had for years. The telescope, as well as the woven picnic basket next to it, accumulated dew while you were asleep.

>n
The Field (north)
A patch of lavender is growing here. Further north is a dense forest, with leaves that swish in the breeze.

>s
The Field (center)
A lush expanse of tall grass interspersed with wildflowers. Your picnic blanket is spread across the ground, and standing on top is the telescope you've had for years. The telescope, as well as the woven picnic basket next to it, accumulated dew while you were asleep.

In your peripheral vision, a moth flits by.

>n
The Field (north)
A patch of lavender is growing here. Further north is a dense forest, with leaves that swish in the breeze.

>ns
That's not a verb I recognise.

>n
You can't go that way.

>s
The Field (center)
A lush expanse of tall grass interspersed with wildflowers. Your picnic blanket is spread across the ground, and standing on top is the telescope you've had for years. The telescope, as well as the woven picnic basket next to it, accumulated dew while you were asleep.

* * *

>n
The Field (north)
A patch of lavender is growing here. Further north is a dense forest, with leaves that swish in the breeze.

>s
The Field (center)
A lush expanse of tall grass interspersed with wildflowers. Your picnic blanket is spread across the ground, and standing on top is the telescope you've had for years. The telescope, as well as the woven picnic basket next to it, accumulated dew while you were asleep.

A duck quacks abruptly from weirdly close by.

>n
The Field (north)
A patch of lavender is growing here. Further north is a dense forest, with leaves that swish in the breeze.

The persistent chirp of a cricket pierces the air.

>s
The Field (center)
A lush expanse of tall grass interspersed with wildflowers. Your picnic blanket is spread across the ground, and standing on top is the telescope you've had for years. The telescope, as well as the woven picnic basket next to it, accumulated dew while you were asleep.

The persistent chirp of a cricket pierces the air.

>n
The Field (north)
A patch of lavender is growing here. Further north is a dense forest, with leaves that swish in the breeze.

* * *

>s
The Field (center)
A lush expanse of tall grass interspersed with wildflowers. Your picnic blanket is spread across the ground, and standing on top is the telescope you've had for years. The telescope, as well as the woven picnic basket next to it, accumulated dew while you were asleep.

A duck quacks abruptly from weirdly close by.

>n
The Field (north)
A patch of lavender is growing here. Further north is a dense forest, with leaves that swish in the breeze.

I beg your pardon?

* * *

>s
The Field (center)
A lush expanse of tall grass interspersed with wildflowers. Your picnic blanket is spread across the ground, and standing on top is the telescope you've had for years. The telescope, as well as the woven picnic basket next to it, accumulated dew while you were asleep.

>s
The Field (south)

>n
The Field (center)

>e
The Field (east)

>w
The Field (center)

>w
The Field (west)

>e
The Field (center)

>nw
The Field (northwest)

>e
The Field (north)

>e
The Field (northeast)

>s
The Field (east)

>s
The Field (southeast)

>w
The Field (south)

>w
The Field (southwest)

>n
The Field (west)

>e
The Field (center)

>n
The Field (north)

>n
You can't go that way.

* * *

You stir from a short night's sleep (maybe more of a long nap). It is still the wee hours of the morning, but you can make out your surroundings in silhouette.

Challenge 3
An Interactive Fiction by Tulasi Holdridge
Release 1 / Serial number 201102 / Inform 7 build 6M62 (I6/v6.34 lib 6/12N) SD

The Field (center)
A lush expanse of tall grass interspersed with wildflowers. Your picnic blanket is spread across the ground, and standing on top is the telescope you've had for years. The telescope, as well as the woven picnic basket next to it, accumulated dew while you were asleep.

>test
>--> No test scripts exist for this game.

>look
The Field (center)
A lush expanse of tall grass interspersed with wildflowers. Your picnic blanket is spread across the ground, and standing on top is the telescope you've had for years. The telescope, as well as the woven picnic basket next to it, accumulated dew while you were asleep.

>x
What do you want to examine?

>hm
You can't see any such thing.

>n
The Field (north)
A patch of lavender is growing here. Further north is a dense forest, with leaves that swish in the breeze.

* * *

>s
The Field (center)
A lush expanse of tall grass interspersed with wildflowers. Your picnic blanket is spread across the ground, and standing on top is the telescope you've had for years. The telescope, as well as the woven picnic basket next to it, accumulated dew while you were asleep.

>sn
That's not a verb I recognise.

* * *

You stir from a short night's sleep (maybe more of a long nap). It is still the wee hours of the morning, but you can make out your surroundings in silhouette.

Challenge 3
An Interactive Fiction by Tulasi Holdridge
Release 1 / Serial number 201102 / Inform 7 build 6M62 (I6/v6.34 lib 6/12N) SD

The Field (center)
A lush expanse of tall grass interspersed with wildflowers. Your picnic blanket is spread across the ground, and standing on top is the telescope you've had for years. The telescope, as well as the woven picnic basket next to it, accumulated dew while you were asleep.

>wait
Time passes.

* * *

You stir from a short night's sleep (maybe more of a long nap). It is still the wee hours of the morning, but you can make out your surroundings in silhouette.

Challenge 3
An Interactive Fiction by Tulasi Holdridge
Release 1 / Serial number 201102 / Inform 7 build 6M62 (I6/v6.34 lib 6/12N) SD

The Field (center)
A lush expanse of tall grass interspersed with wildflowers. Your picnic blanket is spread across the ground, and standing on top is the telescope you've had for years. The telescope, as well as the woven picnic basket next to it, accumulated dew while you were asleep.

>x telescope
This sleek black telescope has served you well, ever since you were a kid obsessed with going to space. Being an astronaut is no longer on the cards for you, but the telescope has remained a steadfast companion on camping trips and apartment rooftops.

>x blanket
Once upon a time, this blanket was a crisp white, but many escapades later it's more of an off-yellow.

>x basket
Your only new-looking item. Well, it isn't new, but the in-laws gave it to you when they finally sorted through the junk from her childhood bedroom. It probably hasn't been used since the 2010"s.

>n
The Field (north)
A patch of lavender is growing here. Further north is a dense forest, with leaves that swish in the breeze.

>x lavender
As you lean in, the breeze wafts the overwhelming scent of the flowers toward you.

>n
You can't go that way.

>wait
Time passes.

>wait
Time passes.

>waiy
That's not a verb I recognise.

>g
That's not a verb I recognise.

>wait
Time passes.

>s
The Field (center)
A lush expanse of tall grass interspersed with wildflowers. Your picnic blanket is spread across the ground, and standing on top is the telescope you've had for years. The telescope, as well as the woven picnic basket next to it, accumulated dew while you were asleep.

>s
The Field (south)
Here, the grass becomes more sparse, and soil fades to sand. Farther off, you can see low dunes with occasional vegatation.

>x dunes
You can't see any such thing.

>n
The Field (center)
A lush expanse of tall grass interspersed with wildflowers. Your picnic blanket is spread across the ground, and standing on top is the telescope you've had for years. The telescope, as well as the woven picnic basket next to it, accumulated dew while you were asleep.

>s
The Field (south)
Here, the grass becomes more sparse, and soil fades to sand. Farther off, you can see low dunes with occasional vegatation.

* * *

>n
The Field (center)
A lush expanse of tall grass interspersed with wildflowers. Your picnic blanket is spread across the ground, and standing on top is the telescope you've had for years. The telescope, as well as the woven picnic basket next to it, accumulated dew while you were asleep.

>w
The Field (west)

>e
The Field (center)
A lush expanse of tall grass interspersed with wildflowers. Your picnic blanket is spread across the ground, and standing on top is the telescope you've had for years. The telescope, as well as the woven picnic basket next to it, accumulated dew while you were asleep.

>n
The Field (north)
A patch of lavender is growing here. Further north is a dense forest, with leaves that swish in the breeze.

* * *

>s
The Field (center)
A lush expanse of tall grass interspersed with wildflowers. Your picnic blanket is spread across the ground, and standing on top is the telescope you've had for years. The telescope, as well as the woven picnic basket next to it, accumulated dew while you were asleep.

>w
The Field (west)

>w
You can't go that way.

>s
The Field (southwest)

>c
That's not a verb I recognise.

>se
You can't go that way.

>ne
The Field (center)
A lush expanse of tall grass interspersed with wildflowers. Your picnic blanket is spread across the ground, and standing on top is the telescope you've had for years. The telescope, as well as the woven picnic basket next to it, accumulated dew while you were asleep.

>x telescope
This sleek black telescope has served you well, ever since you were a kid obsessed with going to space. Being an astronaut is no longer on the cards for you, but the telescope has remained a steadfast companion on camping trips and apartment rooftops.

>look through telescope
You find nothing of interest.

>x blanket
Once upon a time, this blanket was a crisp white, but many escapades later it's more of an off-yellow.

* * *

>x basket
Your only new-looking item. Well, it isn't new, but the in-laws gave it to you when they finally sorted through the junk from her childhood bedroom. It probably hasn't been used since the 2010"s.

>wait
Time passes.

>wai
That's not a verb I recognise.

>wait
Time passes.

>n
The Field (north)
A patch of lavender is growing here. Further north is a dense forest, with leaves that swish in the breeze.

>s
The Field (center)
A lush expanse of tall grass interspersed with wildflowers. Your picnic blanket is spread across the ground, and standing on top is the telescope you've had for years. The telescope, as well as the woven picnic basket next to it, accumulated dew while you were asleep.

You see a slow lightening of the sky to the east. Above you, stars are still splashed across the darkness.