Your new employer has sent you to her personal library as a challenge, and you must escape it. Your only instructions are that, if you try to open the door with the wrong key, the test will be considered an utter failure.

Challenge2
An Interactive Fiction by Tulasi Holdridge
Release 1 / Serial number 200702 / Inform 7 build 6M62 (I6/v6.34 lib 6/12N) SD

Library
You're in a small library with wooden bookshelves on the north and east walls. There is an arched window on the west wall, and an ornate red door to the south. Nestled at the corner where the bookshelves intersect, a velvety armchair sits behind a low table.

>take armchair
That's fixed in place.

>x armchair
A well-loved chair with dusky pink upholstery.

>x window
The window seems to sealed shut, but on the sill is a small scrap of paper that you hadn't noticed at first glance.

>x east shelf
The shelf is filled with ancient books that you would love to read, but most don't look particularly helpful right now. One slim volume catches your eye; it looks to be newer than the others, and simply has the word "DIARY" on its spine.

>take diary
Taken.

>x north shelf
A lifetime's worth of knowledge sits on this shelf, and you can't waste time looking through every book. If you want to find a particular book, you'll have to examine it directly.

>x table
A low table with a mahogany lacquer and curved legs. Tucked under the tabletop is a closed drawer.

>open drawer
You open the drawer, revealing a map.

* * *

>x east shelf
The shelf is filled with ancient books that you would love to read, but most don't look particularly helpful right now. One slim volume catches your eye; it looks to be newer than the others, and simply has the word "DIARY" on its spine.

>x diary
A small book, out of place among the heavier tomes around it. You'd have to take the diary to discern anything about its contents.

>take diary
Taken.

>x diary
You open the book, but it appears blank except for one page near the back. However, instead of words, there is an incomprehensible string of letters: "llg tswwfqfo papn iiowen psnj rgox llir."

>x windo
You can't see any such thing.

>x window
The window seems to sealed shut, but on the sill is a small scrap of paper that you hadn't noticed at first glance.

>take paper
Taken.

>take scrap of paper
You already have that.

>x scrap of paper
The words "decrypt Vigenere key SECRET" are scrawled on the paper in hasty handwriting.

>w
You can't go that way.

>n
You can't go that way.

>x codebook
A thick book with embossed writing on its spine that reads "The complete guide to ciphers and codes." You'd have to take the codebook to learn anything about its contents.

>take codebook
You begin to pull the codebook toward you. With an abrupt crunching sound followed by a rapid clicking, the bookshelf slides to the left, toward the west wall. It only opens a couple feet, but the dark space it reveals seems large enough to fit through without too much trouble.

>n
Secret Office
This room is mostly empty, and lit by an eerie purple light that makes its white walls glow. In the middle is a desk, and atop it is a heavy-looking trunk.

>take codebook
You can't see any such thing.

>x codebook
You can't see any such thing.

>x desk
You see nothing special about the desk.

>x trunk
A substantial trunk made of wood and iron.

>open trunk
Inside are two keys, one pink and one purple.

>take keys
You can't see any such thing.

>s
Library
You're in a small library with wooden bookshelves on the north and east walls. There is an arched window on the west wall, and an ornate red door to the south. Nestled at the corner where the bookshelves intersect, a velvety armchair sits behind a low table.

>open drawer
You open the drawer, revealing a map.

>take map
Taken.

>x map
A simple map of the world. It uses the Robinson projection, if that sort of thing matters to you.

>n
Secret Office
This room is mostly empty, and lit by an eerie purple light that makes its white walls glow. In the middle is a desk, and atop it is a heavy-looking trunk.

>x map
Under the office's UV light, you can see that certain cities are circled on the map: Nashville, Aswan, Taguig, Indore, Oslo, Nairobi.